10
10
64
2 2 2 2 2 2 2 2 2 2
2 2 2 2 2 2 2 2 2 2
2 2 2 2 2 2 2 2 2 2
7 8 9 2 2 2 2 2 2 2
7 8 9 2 2 7 8 9 2 2
4 5 6 2 2 4 5 6 2 2
3 3 3 2 2 3 3 3 2 2
2 2 2 2 2 2 2 2 2 2
2 2 2 2 2 2 2 2 2 2
2 2 2 2 2 2 2 2 2 2